C 9
#########
#      A#
#@@@ FG #
#       #
#  I    #
#E@     #
#@#@  J #
# @ H   #
#########

E 5
#####
#   #
#   #
#   #
#####

F 5
#####
#   #
#   #
#   #
#####

G 5
#####
#   #
#   #
#   #
#####

H 5
#####
#   #
#   #
#   #
#####

I 1
 

J 5
#####
#   #
#   #
#   #
#####

