C 12
############
#A         #
#########  #
#          #
#  @    Y  #
## #########
#        @ #
###### #####
#          #
#R########Z#
#@   bb   @#
############

E 3
EEE
E E
EEE

