C 9
#########
#  I###J#
#   #H  #
#     #@#
#A F ####
#     K##
#    # G#
#E   ##@#
#########

I 5
## ##
#####
#### 
#####
#####

J 5
#####
#   #
#   #
#   #
#####

H 5
#####
#   #
#   #
#   #
#####

F 5
#####
#   #
#   #
#   #
#####

K 5
#####
#####
 ####
 ####
 # ##

G 5
#####
#   #
#   #
#   #
#####

E 1
 

