C 15
###############
#             #
#Y            #
#@@@@@IJDHA   #
#      #      #
#             #
#L          ###
#@B  ZT  #   ##
#@#@### #### ##
###@##@       #
#@ ## ##      #
# D     ## G  #
# ###@R@#     #
#             #
###############

I 5
#####
#   #
#   #
#   #
#####

J 5
#####
#   #
#   #
#   #
#####

D 1
 

H 5
#####
#   #
#   #
#   #
#####

G 1
 

F 1
 

