C 15
###############
#            @#
#             #
#  D D @ I J  #
#      #      #
#    D   H    #
#      A    ###
#@       #   ##
#@#@### #### ##
###@##@       #
#@ ## ##      #
# D    F## G  #
# ###@ @#     #
#             #
###############

I 5
#####
#   #
#   #
#   #
#####

J 5
#####
#   #
#   #
#   #
#####

D 1
 

H 5
#####
#   #
#   #
#   #
#####

G 1
 

F 1
 

