C 8
########
#      #
# F  I #
#  A   #
#@  E  #
# H  G #
#      #
########

F 5
#####
#   #
#   #
#   #
#####

I 4
    
    
    
    

E 2
@@
@@

H 5
#####
#   #
#   #
#   #
#####

G 5
#####
#   #
#   #
#   #
#####

