C 9
#########
#       #
#      @#
#   B  E#
# @     #
# @ A B #
# @     #
#       #
#########

E 1
#

