C 7
#######
###  ##
#@@  ##
#@@A E#
#@@  ##
### @##
#######

E 3
EEE
E E
EEE

