C 7
#######
#D#   #
#E    #
##    #
#FGHIJ#
##DDD##
#######

D 1
 

E 5
#####
##   
## ##
   ##
#####

F 5
#####
#####
#####
###@ 
#####

G 5
#####
     
#####
#####
#####

H 5
#####
#####
#####
     
#####

I 5
#####
   ##
## ##
##   
#####

J 5
## ##
   ##
#####
#####
#####

