C 7
#######
#@#  A#
#     #
##    #
# GHI #
##@@@##
#######

D 1
 

E 5
#####
##   
## ##
   ##
#####

F 5
#####
#####
#####
###@ 
#####

G 5
#####
     
#####
#####
#####

H 5
#####
#####
#####
     
#####

I 5
#####
   ##
## ##
##   
#####

J 5
## ##
   ##
#####
#####
#####

