C 6
######
#   E#
# A  #
#  @ #
#G   #
######

E 4
#   
F # 
 ## 
 @  

F 5
#####
#   #
#   #
#   #
#####

G 2
H 
@ 

H 5
#####
#   #
#   #
#   #
#####

