C 10
##########
#  ## #A##
##      ##
#@D # # ##
##  ######
#  ##@#@##
##      ##
#  ##D#D##
#@      ##
##########


