C 7
#######
#     #
# G H #
# E A@#
# F I #
#     #
#######

G 5
#####
#   #
#   #
#   #
#####

H 1
@
 
 
 
@

E 5
#####
#   #
#   #
#   #
#####

F 5
#####
#   #
#   #
#   #
#####

I 5
@   @

