C 11
###########
#B  ###E F#
#B  ###HIQ#
#B  S##T U#
## ##### ##
#  B####  #
#I# #### I#
###B B## ##
##### #Y ##
#####B  ###
###########

E 5
#####
#####
  ###
# ###
# ###

F 3
###
 ##
###

H 5
# ###
# ###
#   #
### #
### #

I 1
B
B
B
B
B
B
B

Q 3
###
 ##
###

S 5
#####
 @###
#####
#####
#####

T 5
### #
###  
#####
#####
#####

U 3
###
 ##
###

Y 5
#####
#####
###  
### #
### #

