C 8
########
#@b  b@#
#bbC bb#
#  A  B#
#   D  #
#bb  bb#
#@b  b@#
########

F 5
#####
#   #
#   #
#   #
#####

I 4
    
    
    
    

E 2
@@
@@

H 5
#####
#   #
#   #
#   #
#####

G 5
#####
#   #
#   #
#   #
#####

