C 6
######
#@ #@#
# G#b#
#    #
#A   #
######

E 4
#   
F # 
 ## 
 @  

F 5
#####
#   #
#   #
#   #
#####

G 2
H 
@ 

H 5
#####
#   #
#   #
#   #
#####

