C 9
#########
#       #
# F E A #
#   @   #
# H@@@G #
#   @   #
# K J I #
#       #
#########

F 5
#####
#   #
#   #
#   #
#####

E 5
#####
#   #
#   #
#   #
#####

H 5
#####
#   #
#   #
#   #
#####

G 5
#####
#   #
#   #
#   #
#####

K 3
###
  #
# #

J 5
#####
#   #
#   #
#   #
#####

I 5
#####
#   #
#   #
#   #
#####

