C 9
#########
###     #
#   D E #
#   @   #
# A@@@G #
#   @   #
# H I J #
#       #
#########

D 5
#####
#   #
#   #
#   #
#####

E 5
#####
#   #
#   #
#   #
#####

G 5
#####
#   #
#   #
#   #
#####

H 5
#####
#   #
#   #
#   #
#####

I 5
#####
#   #
#   #
#   #
#####

J 5
#####
#    
# ## 
#    
## ##

