C 7
### ###
#@#  @#
# #   #
# #E A#
# #   #
#  C  #
#######

E 5
#####
#   #
#   #
#   #
#####

