C 12
############
#          #
#          #
# a      a #
#  a    a  #
#   a  a   #
#    aa    #
#          #
#          #
#  bbbbbb  #
#          #
############



