C 12
############
#          #
#          #
# a      a #
#  a    a  #
#   a  a   #
#    aa    #
#          #
#          #
#  bbbbbb  #
#          #
############

G 5
#####
#   #
#   #
#   #
#####

H 1
@
 
 
 
@

E 5
#####
#   #
#   #
#   #
#####

F 5
#####
#   #
#   #
#   #
#####

I 5
@   @

