C 9
#########
#!D ##D#D#
##      #
#@D #@#@#
##  #####
#D ##@#@#
##      #
#E ##D#D#
#########

D 1
 

E 5
#####
#####
#JHF 
#####
#####

J 3
###
#@#
#K#

K 1
 

H 3
###
#@#
#I#

I 1
 

F 3
###
#@#
#G#

G 1
 

